5
0,1,0,2,5
1,1,0,2,4
2,1,1,2,3
3,1,0,2,2
4,1,0,2,1
